PREFIX vta: <http://www.semanticweb.org/anon/ontologies/2021/3/>
 
OBJECT thing iswc_2007 -> vta:iswc_2007
OBJECT thing aa -> vta:aa
OBJECT thing ab -> vta:ab
OBJECT thing ac -> vta:ac
OBJECT thing ad -> vta:ad
OBJECT thing ae -> vta:ae
OBJECT thing af -> vta:af
OBJECT thing ag -> vta:ag
OBJECT thing ah -> vta:ah
OBJECT thing ai -> vta:ai
OBJECT thing aj -> vta:aj
OBJECT thing ak -> vta:ak
OBJECT thing al -> vta:al
OBJECT thing am -> vta:am
OBJECT thing an -> vta:an
OBJECT thing ao -> vta:ao
OBJECT thing ap -> vta:ap
OBJECT thing aq -> vta:aq
OBJECT thing ar -> vta:ar
OBJECT thing as -> vta:as
OBJECT thing at -> vta:at


PREDICATE ariportShuttle(thing, thing) -> vta:airportShuttle
PREDICATE notFree(thing) -> vta:notFree
PREDICATE carHotelBundleOption(thing, thing) -> vta:carHotelBundleOption
PREDICATE carRentalBooking(thing, thing) -> vta:carRentalBooking
PREDICATE hotelStayConfirmation(thing, thing) -> vta:hotelStayConfirmation
PREDICATE flightTicket(thing, thing) -> vta:flightTicket
PREDICATE itinerary(thing, thing) -> vta:itinerary
PREDICATE invoice(thing, thing) -> vta:invoice
PREDICATE flightRequest(thing, thing) -> vta:flightRequest
PREDICATE hotelStayRequest(thing, thing) -> vta:hotelStayRequest
PREDICATE carRentalRequest(thing, thing) -> vta:carRentalRequest
