PREFIX vta: <http://www.semanticweb.org/anon/ontologies/2021/3/>
 
OBJECT thing iswc_2007 -> vta:iswc_2007
OBJECT thing aa -> vta:aa
OBJECT thing ab -> vta:ab
OBJECT thing ac -> vta:ac
OBJECT thing ad -> vta:ad
OBJECT thing ae -> vta:ae
OBJECT thing af -> vta:af
OBJECT thing ag -> vta:ag
OBJECT thing ah -> vta:ah
OBJECT thing ai -> vta:ai
OBJECT thing aj -> vta:aj
OBJECT thing ak -> vta:ak
OBJECT thing al -> vta:al
OBJECT thing am -> vta:am
OBJECT thing an -> vta:an
OBJECT thing ao -> vta:ao
OBJECT thing ap -> vta:ap
OBJECT thing aq -> vta:aq
OBJECT thing ar -> vta:ar
OBJECT thing as -> vta:as
OBJECT thing at -> vta:at
OBJECT thing au -> vta:au
OBJECT thing av -> vta:av
OBJECT thing aw -> vta:aw
OBJECT thing ax -> vta:ax
OBJECT thing ay -> vta:ay
OBJECT thing az -> vta:az
OBJECT thing ba -> vta:ba
OBJECT thing bb -> vta:bb
OBJECT thing bc -> vta:bc
OBJECT thing bd -> vta:bd
OBJECT thing be -> vta:be
OBJECT thing bf -> vta:bf
OBJECT thing bg -> vta:bg
OBJECT thing bh -> vta:bh
OBJECT thing bi -> vta:bi
OBJECT thing bj -> vta:bj
OBJECT thing bk -> vta:bk
OBJECT thing bl -> vta:bl
OBJECT thing bm -> vta:bm
OBJECT thing bn -> vta:bn
OBJECT thing bo -> vta:bo
OBJECT thing bp -> vta:bp
OBJECT thing bq -> vta:bq
OBJECT thing br -> vta:br
OBJECT thing bs -> vta:bs
OBJECT thing bt -> vta:bt
OBJECT thing bu -> vta:bu
OBJECT thing bv -> vta:bv
OBJECT thing bw -> vta:bw
OBJECT thing bx -> vta:bx
OBJECT thing by -> vta:by
OBJECT thing bz -> vta:bz
OBJECT thing ca -> vta:ca
OBJECT thing cb -> vta:cb
OBJECT thing cc -> vta:cc


PREDICATE ariportShuttle(thing) -> vta:airportShuttle
PREDICATE notFree(thing) -> vta:notFree
PREDICATE carHotelBundleOption(thing) -> vta:carHotelBundleOption
PREDICATE carRentalBooking(thing) -> vta:carRentalBooking
PREDICATE hotelStayConfirmation(thing) -> vta:hotelStayConfirmation
PREDICATE flightTicket(thing) -> vta:flightTicket
PREDICATE itinerary(thing) -> vta:itinerary
PREDICATE invoice(thing) -> vta:invoice
PREDICATE flightRequest(thing) -> vta:flightRequest
PREDICATE hotelStayRequest(thing) -> vta:hotelStayRequest
PREDICATE carRentalRequest(thing) -> vta:carRentalRequest
